void=void	null	-1
int=void	null	-1
float=void	null	-1
char=void	null	-1
boolean=void	null	-1
string=void	null	-1
void+void	null	-1
int+void	null	-1
float+void	null	-1
char+void	null	-1
boolean+void	null	-1
string+void	null	-1
void-void	null	-1
int-void	null	-1
float-void	null	-1
char-void	null	-1
boolean-void	null	-1
string-void	null	-1
void/void	null	-1
int/void	null	-1
float/void	null	-1
char/void	null	-1
boolean/void	null	-1
string/void	null	-1
void*void	null	-1
int*void	null	-1
float*void	null	-1
char*void	null	-1
boolean*void	null	-1
string*void	null	-1
void>void	null	-1
int>void	null	-1
float>void	null	-1
char>void	null	-1
boolean>void	null	-1
string>void	null	-1
void<void	null	-1
int<void	null	-1
float<void	null	-1
char<void	null	-1
boolean<void	null	-1
string<void	null	-1
void>=void	null	-1
int>=void	null	-1
float>=void	null	-1
char>=void	null	-1
boolean>=void	null	-1
string>=void	null	-1
void<=void	null	-1
int<=void	null	-1
float<=void	null	-1
char<=void	null	-1
boolean<=void	null	-1
string<=void	null	-1
void==void	null	-1
int==void	null	-1
float==void	null	-1
char==void	null	-1
boolean==void	null	-1
string==void	null	-1
void!=void	null	-1
int!=void	null	-1
float!=void	null	-1
char!=void	null	-1
boolean!=void	null	-1
string!=void	null	-1
boolean=boolean	boolean	0
int=string	null	-1
char=char	char	0
char=string	null	-1
(int)float	int	0
(int)int	int	0
(int)char	int	0
(int)boolean	null	-1
(float)int	float	0
(float)char	null	-1
(float)float	float	0
(float)boolean	null	-1
(char)int	char	0
(char)float	null	-1
(char)char	char	0
(char)boolean	null	-1
(boolean)float	null	-1
(boolean)int	null	-1
(boolean)char	null	-1
(boolean)string	null	-1
(int)string	null	-1
(char)string	null	-1
(float)string	null	-1
(boolean)boolean	boolean	0
int+char	char	0
int-char	char	0
int/char	char	0
int*char	char	0
int=char	int	2
int==char	int	2
int!=char	int	2
int>char	int	2
int<char	int	2
int>=char	int	2
int<=char	int	2
char+int	char	0
char-int	char	0
char/int	char	0
char*int	char	0
char=int	null	-1
char==int	int	2
char!=int	int	2
char>int	int	2
char<int	int	2
char>=int	int	2
char<=int	int	2
char+float	null	-1
char-float	null	-1
char/float	null	-1
char*float	null	-1
char=float	null	-1
char==float	null	-1
char!=float	null	-1
char>float	null	-1
char<float	null	-1
char>=float	null	-1
char<=float	null	-1
float+char	null	-1
float-char	null	-1
float/char	null	-1
float*char	null	-1
float=char	null	-1
float==char	null	-1
float!=char	null	-1
float>char	null	-1
float<char	null	-1
float>=char	null	-1
float<=char	null	-1
char+char	int	3
char-char	int	3
char/char	int	3
char*char	int	3
char=char	char	0
char==char	boolean	0
char!=char	boolean	0
char>char	boolean	0
char<char	boolean	0
char>=char	boolean	0
char<=char	boolean	0
int+boolean	null	-1
int-boolean	null	-1
int/boolean	null	-1
int*boolean	null	-1
int=boolean	null	-1
int==boolean	null	-1
int!=boolean	null	-1
int>boolean	null	-1
int<boolean	null	-1
int>=boolean	null	-1
int<=boolean	null	-1
intandboolean	null	-1
intorboolean	null	-1
int=float	int	1
int+float	float	1
int-float	float	1
int*float	float	1
int/float	float	1
int>int	boolean	0
int<int	boolean	0
int>=int	boolean	0
int<=int	boolean	0
int==int	boolean	0
int!=int	boolean	0
int>float	boolean	0
int<float	boolean	0
int>=float	boolean	0
int<=float	boolean	0
int==float	boolean	0
int!=float	boolean	0
boolean+int	null	-1
boolean-int	null	-1
boolean/int	null	-1
boolean*int	null	-1
boolean=int	null	-1
booleanandboolean	boolean	0
booleanorboolean	boolean	0
boolean==boolean	boolean	0
boolean!=boolean	boolean	0
booleanandint	null	-1
booleanorint	null	-1
float+boolean	null	-1
float-boolean	null	-1
float/boolean	null	-1
float*boolean	null	-1
float=boolean	null	-1
boolean+float	null	-1
boolean-float	null	-1
boolean/float	null	-1
boolean*float	null	-1
boolean=float	null	-1
floatandboolean	null	-1
floatorboolean	null	-1
booleanandfloat	null	-1
booleanorfloat	null	-1
char+boolean	null	-1
char-boolean	null	-1
char/boolean	null	-1
char*boolean	null	-1
char=boolean	null	-1
boolean+char	null	-1
boolean-char	null	-1
boolean/char	null	-1
boolean*char	null	-1
boolean=char	null	-1
charandboolean	null	-1
charorboolean	null	-1
booleanandchar	null	-1
booleanorchar	null	-1
boolean=int	null	-1
float=int	float	1
float*int	float	2
float-int	float	2
float+int	float	2
float/int	float	2
float=float	float	0
float+float	float	0
float-float	float	0
float*float	float	0
float/float	float	0
int=int	int	0
int+int	int	0
int-int	int	0
int*int	int	0
int/int	int	0
float<int	boolean	0
float>=int	boolean	0
float<=int	boolean	0
float==int	boolean	0
float!=int	boolean	0
char<int	null	-1
char>=int	null	-1
char<=int	null	-1
char==int	null	-1
char!=int	null	-1
string=string	string	0
string=char	string	0
string+string	string	0
string+int	null	-1
int+string	null	-1
string+char	string	0
char+string	string	0
string+float	null	-1
float+string	null	-1
string+boolean	null	-1
boolean+string	null	-1
string-string	null	-1
string-int	null	-1
string-char	null	-1
string-float	null	-1
string-boolean	null	-1
string-string	null	-1
int-string	null	-1
char-string	null	-1
float-string	null	-1
boolean-string	null	-1
string*string	null	-1
string*int	null	-1
string*char	null	-1
string*float	null	-1
string*boolean	null	-1
string*string	null	-1
int*string	null	-1
char*string	null	-1
float*string	null	-1
boolean*string	null	-1
string/string	null	-1
string/int	null	-1
string/char	null	-1
string/float	null	-1
string/boolean	null	-1
string/string	null	-1
int/string	null	-1
char/string	null	-1
float/string	null	-1
boolean/string	null	-1
string>string	boolean	0
string>=string	boolean	0
string<string	boolean	0
string<=string	boolean	0
string==string	boolean	0
string!=string	boolean	0